>NC_000017.11:c41041450-41040541 KRTAP1-1 [organism=Homo sapiens] [GeneID=81851] [chromosome=17]
ATAATTCAGAAACTCCTCCAAGCAACCCAACCTTCAGATCAACTCCTGACACCATGGCCTGCTGTCAGAC
CAGCTTCTGTGGATTTCCCAGCTGCTCCACCAGTGGGACCTGCGGCTCCAGCTGCTGCCAGCCAAGCTGC
TGTGAGACCAGCTCCTGCCAGCCACGCTGCTGTGAGACCAGCTGCTGCCAGCCAAGCTGCTGCCAGACCA
GCTTCTGTGGATTTCCTAGCTTCTCAACCGGTGGGACTTGTGACTCTAGCTGCTGCCAGCCAAGCTGCTG
TGAAACTAGCTGCTGCCAGCCAAGCTGCTACCAGACCAGCTCCTGCGGAACTGGCTGTGGCATTGGTGGT
GGCATTGGCTATGGCCAGGAGGGCAGCAGTGGAGCTGTGAGCACCCGTATCAGGTGGTGCCGCCCAGACT
GCCGTGTGGAGGGTACCTGCCTGCCCCCCTGCTGCGTGGTGAGCTGCACACCCCCATCCTGCTGCCAGCT
GCACCACGCCGAGGCCTCCTGCTGCCGCCCATCCTACTGTGGACAGTCCTGTTGCCGCCCAGTCTGCTGC
TGCTACTGCTCTGAGCCCACTTGTTGAAAACCTCCTTCTGCTGGGGATCCTGATAAGATGGCACCTTAAA
ACTAGCCAAATTAGAATCCTAACAATCTTCTGAACTCCAGTACCTATAACTGGGCTTGCAACCTCTCATC
ACACAGCCACATAAATTCCCTAGGAAGTAAATTCATTTACAATGGAAGACCAAAAATTTTTCCTAGACCT
GGTTGTCAGCCAAAGTCCTACAATGTGAAAAGAGTTAGATACTATTTTACTATAAATATCACCTGAAATA
TTTCAACAGTTATTGGGACTTAAATTTAATAAAAGTTTTCATCTCTTCAATGATGAAGTTGTTGTTTGAA
